Player,Age,Team,Pos,GP,G,A,PTS,+/-,PIM
Nikita Kucherov,30,TBL,RW,81,44,100,144,8,22
Nathan MacKinnon,28,COL,C,82,51,89,140,35,42
Connor McDavid,27,EDM,C,76,32,100,132,35,30
Artemi Panarin,32,NYR,LW,82,49,71,120,18,24
David Pastrňák,27,BOS,RW,82,47,63,110,21,47
Auston Matthews,26,TOR,C,81,69,38,107,31,20
Leon Draisaitl,28,EDM,C,81,41,65,106,26,76
Mikko Rantanen,27,COL,RW,80,42,62,104,19,50
J.T. Miller,30,VAN,C,81,37,66,103,32,58
William Nylander,27,TOR,C,82,40,58,98,1,24
Kirill Kaprizov,26,MIN,LW,75,46,50,96,11,36
Sidney Crosby,36,PIT,C,82,42,52,94,7,40
Filip Forsberg,29,NSH,C,82,48,46,94,16,43
Sam Reinhart,28,FLA,C,82,57,37,94,29,31
Quinn Hughes,24,VAN,D,82,17,75,92,38,38
Cale Makar,25,COL,D,77,21,69,90,15,16
Brayden Point,27,TBL,C,81,46,44,90,-16,14
Sebastian Aho,26,CAR,F,78,36,53,89,34,36
Elias Pettersson,25,VAN,C,82,34,55,89,20,12
Matthew Tkachuk,26,FLA,LW,80,26,62,88,19,88
Robert Thomas,24,STL,C,82,26,60,86,9,48
Roman Josi,33,NSH,D,82,23,62,85,12,45
Mitch Marner,26,TOR,RW,69,26,59,85,21,18
Jesper Bratt,25,NJD,W,82,27,56,83,-6,12
Evan Bouchard,24,EDM,D,81,18,64,82,34,32
Steven Stamkos,33,TBL,C,79,40,41,81,-21,34
Aleksander Barkov,28,FLA,C,73,23,57,80,33,24
Mathew Barzal,26,NYI,C,80,23,57,80,-4,34
Jason Robertson,24,DAL,LW,82,29,51,80,19,22
Zach Hyman,31,EDM,LW,80,54,23,77,36,48
Nick Suzuki,24,MTL,C,82,33,44,77,-14,36
Vincent Trocheck,30,NYR,C,82,25,52,77,16,55
Victor Hedman,33,TBL,D,78,13,63,76,18,76
Clayton Keller,25,ARI,C,78,33,43,76,-20,32
Brandon Hagel,25,TBL,LW,82,26,49,75,1,79
Nazem Kadri,33,CGY,C,82,29,46,75,0,43
Adrian Kempe,27,LAK,LW,77,28,47,75,13,72
Chris Kreider,32,NYR,LW,82,39,36,75,19,26
Gustav Nyquist,34,NSH,RW,81,23,52,75,7,8
Jack Hughes,22,NJD,C,62,27,47,74,-12,12
Brady Tkachuk,24,OTT,LW,81,37,37,74,1,134
Brock Boeser,26,VAN,RW,81,40,33,73,23,14
Kevin Fiala,27,LAK,LW,82,29,44,73,1,62
Adam Fox,25,NYR,D,72,17,56,73,21,36
Lucas Raymond,21,DET,LW,82,31,41,72,-12,30
Mark Scheifele,30,WPG,C,74,25,47,72,19,57
Carter Verhaeghe,28,FLA,C,76,34,38,72,17,36
Mika Zibanejad,30,NYR,C,81,26,46,72,15,30
Noah Dobson,24,NYI,D,79,10,60,70,12,36
Anže Kopitar,36,LAK,C,81,26,44,70,11,22
Tim Stützle,22,OTT,LW,75,18,52,70,-17,28
Matt Boldy,22,MIN,LW,75,29,40,69,5,48
Dylan Larkin,27,DET,C,68,33,36,69,5,39
Jonathan Marchessault,33,VEG,C,82,42,27,69,-2,40
Josh Morrissey,28,WPG,D,81,10,59,69,34,44
Brock Nelson,32,NYI,C,82,34,35,69,-5,28
Ryan O'Reilly,32,NSH,C,82,26,43,69,6,18
Jack Eichel,27,VEG,C,63,31,37,68,4,27
Bo Horvat,28,NYI,C,81,33,35,68,-1,39
Travis Konecny,26,PHI,C,76,33,35,68,4,67
Alex DeBrincat,26,DET,RW,82,27,40,67,1,34
Nico Hischier,25,NJD,C,71,27,40,67,-5,12
Seth Jarvis,21,CAR,C,81,33,34,67,23,14
Jordan Kyrou,25,STL,C,82,31,36,67,-12,22
Evgeni Malkin,37,PIT,C,82,27,40,67,5,70
Brad Marchand,35,BOS,LW,82,29,38,67,2,78
Ryan Nugent-Hopkins,30,EDM,C,80,18,49,67,10,36
Joe Pavelski,39,DAL,C,82,27,40,67,12,20
Dylan Strome,26,WSH,C,82,27,40,67,-13,22
Drake Batherson,25,OTT,C,82,28,38,66,-9,42
Cole Caufield,23,MTL,RW,82,28,37,65,-4,16
Matt Duchene,33,DAL,C,80,25,40,65,15,20
Roope Hintz,27,DAL,LW,80,30,35,65,26,22
Wyatt Johnston,20,DAL,C,82,32,33,65,14,38
Alex Ovechkin,38,WSH,LW,79,31,34,65,-22,20
John Tavares,33,TOR,C,80,29,36,65,2,30
Joel Eriksson Ek,27,MIN,C,77,30,34,64,18,60
Claude Giroux,36,OTT,C,82,21,43,64,-14,26
Pavel Buchnevich,28,STL,LW,80,27,36,63,3,48
Mats Zuccarello,36,MIN,LW,69,12,51,63,-5,30
Mike Matheson,29,MTL,D,82,11,51,62,-24,58
Jared McCann,27,SEA,C,80,29,33,62,-10,31
Connor Bedard,18,CHI,C,68,22,39,61,-44,28
Kyle Connor,27,WPG,LW,65,34,27,61,-6,6
Nikolaj Ehlers,27,WPG,LW,82,25,36,61,27,29
Nick Schmaltz,27,ARI,C,79,22,39,61,-16,10
Jamie Benn,34,DAL,LW,82,21,39,60,8,41
Charlie Coyle,31,BOS,C,82,25,35,60,-2,38
Johnny Gaudreau,30,CBJ,LW,81,12,48,60,-27,22
Mikael Granlund,31,SJS,C,69,12,48,60,-23,32
William Karlsson,31,VEG,C,70,30,30,60,15,22
Frank Vatrano,29,ANA,LW,82,37,23,60,-20,85
Oliver Bjorkstrand,28,SEA,RW,82,20,39,59,-20,12
Rasmus Dahlin,23,BUF,D,81,20,39,59,-3,66
Yegor Sharangovich,25,CGY,C,82,31,28,59,-29,8
Alex Tuch,27,BUF,RW,75,22,37,59,9,54
Pavel Zacha,26,BOS,C,78,21,38,59,12,18
Morgan Rielly,29,TOR,D,72,7,51,58,7,27
Alexis Lafrenière,22,NYR,LW,82,28,29,57,2,40
Matias Maccelli,23,ARI,LW,82,17,40,57,-4,8
Trevor Moore,28,LAK,LW,82,31,26,57,11,28
Zach Werenski,26,CBJ,D,70,11,46,57,0,22
Jonathan Drouin,28,COL,LW,79,19,37,56,12,28
Shayne Gostisbehere,30,DET,D,81,10,46,56,-16,16
Erik Karlsson,33,PIT,D,82,11,45,56,4,44
Bryan Rust,31,PIT,RW,62,28,28,56,10,20
Tage Thompson,26,BUF,C,71,29,27,56,-1,43
Quinton Byfield,21,LAK,C,80,20,35,55,19,42
Blake Coleman,32,CGY,C,78,30,24,54,19,76
Miro Heiskanen,24,DAL,D,71,9,45,54,8,36
Philipp Kurashev,24,CHI,C,75,18,36,54,-44,23
Kyle Palmieri,32,NYI,RW,82,30,24,54,-16,26
Troy Terry,26,ANA,C,76,20,34,54,-10,24
Mason Marchment,28,DAL,F,81,22,31,53,22,54
Martin Nečas,25,CAR,C,77,24,29,53,-9,42
Valeri Nichushkin,28,COL,RW,54,28,25,53,5,22
Mark Stone,31,VEG,RW,56,16,37,53,1,22
Teuvo Teräväinen,29,CAR,F,76,25,28,53,15,10
Owen Tippett,24,PHI,RW,78,28,25,53,-5,12
John Carlson,34,WSH,D,82,10,42,52,-7,40
Jake Guentzel,29,2TM,C,67,30,47,77,25,22
Jake Guentzel,29,PIT,C,50,22,30,52,9,14
Jake Guentzel,29,CAR,C,17,8,17,25,16,8
Jonathan Huberdeau,30,CGY,LW,81,12,40,52,-29,49
Timo Meier,27,NJD,RW,69,28,24,52,-28,45
Tyler Seguin,32,DAL,C,68,25,27,52,10,26
Andrei Svechnikov,23,CAR,RW,59,19,33,52,13,58
MacKenzie Weegar,30,CGY,D,82,20,32,52,2,51
Kris Letang,36,PIT,D,82,10,41,51,13,62
Chandler Stephenson,29,VEG,C,75,16,35,51,-9,25
Drew Doughty,34,LAK,D,82,15,35,50,15,44
Joel Farabee,23,PHI,LW,82,22,28,50,-13,37
John-Jason Peterka,22,BUF,RW,82,28,22,50,10,28
Juraj Slafkovsky,19,MTL,LW,82,20,30,50,-19,55
Devon Toews,29,COL,D,82,12,38,50,28,18
J.T. Compher,28,DET,LW,77,19,29,48,-5,34
Filip Hronek,26,VAN,D,81,5,43,48,33,38
Dylan Cozens,22,BUF,C,79,18,29,47,-4,42
Phillip Danault,30,LAK,C,78,17,30,47,12,18
Max Domi,28,TOR,LW,80,9,38,47,10,118
Brock Faber,21,MIN,D,82,8,39,47,-1,26
Conor Garland,27,VAN,RW,82,20,27,47,19,35
Thomas Harley,22,DAL,D,79,15,32,47,28,18
Luke Hughes,20,NJD,D,82,9,38,47,-25,28
Patrick Kane,35,DET,RW,50,20,27,47,-5,16
Charlie McAvoy,26,BOS,D,74,12,35,47,4,86
Casey Mittelstadt,25,2TM,C,80,18,39,57,10,32
Casey Mittelstadt,25,BUF,C,62,14,33,47,12,28
Casey Mittelstadt,25,COL,C,18,4,6,10,-2,4
David Perron,35,DET,LW,76,17,30,47,-12,55
Brady Skjei,29,CAR,D,80,13,34,47,15,40
Vince Dunn,27,SEA,D,59,11,35,46,8,78
Nick Paul,28,TBL,LW,82,24,22,46,-16,27
Brayden Schenn,32,STL,C,82,20,26,46,-22,56
Jeff Skinner,31,BUF,LW,74,24,22,46,-2,34
Ivan Barbashev,28,VEG,C,82,19,26,45,15,42
Nick Bjugstad,31,ARI,C,76,22,23,45,11,59
Anthony Cirelli,26,TBL,C,79,20,25,45,2,38
Mattias Ekholm,33,EDM,D,79,11,34,45,44,47
William Eklund,21,SJS,LW,80,16,29,45,-45,30
Ryan Hartman,29,MIN,RW,74,21,24,45,4,72
Alexander Kerfoot,29,ARI,C,82,13,32,45,-15,26
Thomas Novak,26,NSH,C,71,18,27,45,-3,8
Logan Cooley,19,ARI,C,82,20,24,44,-13,18
Jordan Eberle,33,SEA,RW,78,17,27,44,1,17
Evander Kane,32,EDM,LW,77,24,20,44,-4,85
Travis Sanheim,27,PHI,D,81,10,34,44,-20,48
Tyler Toffoli,31,2TM,C,79,33,22,55,-6,14
Tyler Toffoli,31,NJD,C,61,26,18,44,-15,12
Tyler Toffoli,31,WPG,C,18,7,4,11,9,2
Fabian Zetterlund,24,SJS,W,82,24,20,44,-34,33
Tyler Bertuzzi,28,TOR,LW,80,21,22,43,2,53
Brent Burns,38,CAR,D,82,10,33,43,19,20
Daniel Sprong,26,DET,RW,76,18,25,43,-5,22
Lawson Crouse,26,ARI,LW,81,23,19,42,-7,36
Adam Henrique,33,2TM,C,82,24,27,51,9,37
Adam Henrique,33,ANA,C,60,18,24,42,3,33
Adam Henrique,33,EDM,C,22,6,3,9,6,4
Kirill Marchenko,23,CBJ,RW,78,23,19,42,-5,14
Mason McTavish,21,ANA,C,64,19,23,42,-23,86
Brandon Saad,31,STL,LW,82,26,16,42,-4,20
Moritz Seider,22,DET,D,82,9,33,42,-7,51
Shea Theodore,28,VEG,D,47,5,37,42,4,6
Sam Bennett,27,FLA,C,69,20,21,41,17,100
Jakob Chychrun,25,OTT,D,82,14,27,41,-30,60
Sean Durzi,25,ARI,D,76,9,32,41,-1,63
Warren Foegele,27,EDM,LW,82,20,21,41,3,47
Morgan Frost,24,PHI,C,71,13,28,41,4,22
Nicolas Roy,26,VEG,C,70,13,28,41,8,29
Ryan Strome,30,ANA,C,79,11,30,41,-20,86
Vladimir Tarasenko,32,2TM,RW,76,23,32,55,13,12
Vladimir Tarasenko,32,OTT,RW,57,17,24,41,13,12
Vladimir Tarasenko,32,FLA,RW,19,6,8,14,0,0
Eeli Tolvanen,24,SEA,RW,81,16,25,41,-15,24
Ross Colton,27,COL,C,80,17,23,40,-8,61
Jake DeBrusk,27,BOS,LW,80,19,21,40,4,18
Pierre-Luc Dubois,25,LAK,LW,82,16,24,40,-9,70
Trent Frederic,25,BOS,C,82,18,22,40,9,69
Andrew Mangiapane,27,CGY,LW,75,14,26,40,7,47
Marco Rossi,22,MIN,C,82,21,19,40,-4,47
Reilly Smith,32,PIT,RW,76,13,27,40,3,18
Rasmus Andersson,27,CGY,D,78,9,30,39,-11,47
Mikael Backlund,34,CGY,C,82,15,24,39,-4,24
Luke Evangelista,21,NSH,RW,80,16,23,39,0,18
Gustav Forsling,27,FLA,D,79,10,29,39,56,43
Cam Fowler,32,ANA,D,81,5,34,39,-36,24
Morgan Geekie,25,BOS,C,76,17,22,39,6,28
Torey Krug,32,STL,D,77,4,35,39,-31,32
Scott Laughton,29,PHI,C,82,13,26,39,-9,69
Evan Rodrigues,30,FLA,C,80,12,27,39,26,34
Sean Couturier,31,PHI,C,74,11,27,38,-10,29
Jake Neighbours,21,STL,LW,77,27,11,38,-16,21
Cole Perfetti,22,WPG,C,71,19,19,38,13,12
Jake Sanderson,21,OTT,D,79,10,28,38,8,23
James van Riemsdyk,34,BOS,LW,71,11,27,38,7,20
Matthew Beniers,21,SEA,C,77,15,22,37,-11,20
Nick Foligno,36,CHI,LW,74,17,20,37,-29,57
Anders Lee,33,NYI,LW,81,20,17,37,2,68
Vladislav Namestnikov,31,WPG,C,78,11,26,37,17,37
Stefan Noesen,30,CAR,RW,81,14,23,37,13,33
Rickard Rakell,30,PIT,RW,70,15,22,37,4,22
Jaccob Slavin,29,CAR,D,81,6,31,37,21,8
Mason Appleton,28,WPG,C,82,14,22,36,16,26
Michael Bunting,28,2TM,LW,81,19,36,55,-19,57
Michael Bunting,28,CAR,LW,60,13,23,36,-15,55
Michael Bunting,28,PIT,LW,21,6,13,19,-4,2
Danton Heinen,28,BOS,C,74,17,19,36,16,28
Nils Höglander,23,VAN,LW,80,24,12,36,23,51
Alex Killorn,34,ANA,C,63,18,18,36,-15,54
Gabriel Vilardi,24,WPG,C,47,22,14,36,11,14
Jason Dickinson,28,CHI,C,82,22,13,35,4,43
Dylan Guenther,20,ARI,RW,45,18,17,35,-1,14
Noah Hanifin,27,2TM,D,80,13,34,47,19,24
Noah Hanifin,27,CGY,D,61,11,24,35,13,22
Noah Hanifin,27,VEG,D,19,2,10,12,6,2
Erik Haula,32,NJD,LW,76,16,19,35,-1,54
Boone Jenner,30,CBJ,C,58,22,13,35,-8,28
Mathieu Joseph,26,OTT,RW,72,11,24,35,-4,51
Matthew Knies,21,TOR,LW,80,15,20,35,9,45
Adam Lowry,30,WPG,LW,81,12,23,35,17,57
Anton Lundell,22,FLA,C,78,13,22,35,19,46
Sean Monahan,29,2TM,C,83,26,33,59,-1,12
Sean Monahan,29,MTL,C,49,13,22,35,-10,10
Sean Monahan,29,WPG,C,34,13,11,24,9,2
Colton Sissons,30,NSH,C,81,15,20,35,-6,38
Tom Wilson,29,WSH,RW,74,18,17,35,-19,133
Tomáš Hertl,30,2TM,C,54,17,21,38,-28,22
Tomáš Hertl,30,SJS,C,48,15,19,34,-26,22
Tomáš Hertl,30,VEG,C,6,2,2,4,-2,0
Artturi Lehkonen,28,COL,LW,45,16,18,34,11,14
Anthony Mantha,29,2TM,RW,74,23,21,44,11,25
Anthony Mantha,29,WSH,RW,56,20,14,34,5,17
Anthony Mantha,29,VEG,RW,18,3,7,10,6,8
Alex Newhook,23,MTL,C,55,15,19,34,-11,18
Nino Niederreiter,31,WPG,RW,77,18,16,34,12,34
Dmitri Voronkov,23,CBJ,LW,75,18,16,34,-6,52
Connor Zary,22,CGY,C,63,14,20,34,12,22
Andrew Copp,29,DET,C,79,13,20,33,-2,26
Tyson Foerster,22,PHI,RW,77,20,13,33,0,32
Yanni Gourde,32,SEA,C,80,11,22,33,-11,62
Connor McMichael,23,WSH,C,80,18,15,33,-20,34
Dawson Mercer,22,NJD,C,82,20,13,33,-26,29
Brandon Montour,29,FLA,D,66,8,25,33,1,46
Drew O'Connor,25,PIT,F,79,16,17,33,14,20
Jean-Gabriel Pageau,31,NYI,C,82,11,22,33,-8,13
Alex Pietrangelo,34,VEG,D,64,4,29,33,-5,24
Neal Pionk,28,WPG,D,82,5,28,33,9,63
Owen Power,21,BUF,D,76,6,27,33,8,28
Darren Raddysh,27,TBL,D,82,6,27,33,-3,21
Michael Rasmussen,24,DET,C,75,13,20,33,8,47
Oliver Ekman-Larsson,32,FLA,D,80,9,23,32,10,76
Robby Fabbri,28,DET,C,68,18,14,32,-13,32
Dakota Joshua,27,VAN,C,63,18,14,32,19,60
Elias Lindholm,29,2TM,C,75,15,29,44,-14,25
Elias Lindholm,29,CGY,C,49,9,23,32,-8,21
Elias Lindholm,29,VAN,C,26,6,6,12,-6,4
Jordan Martinook,31,CAR,LW,82,14,18,32,-1,36
Ryan McDonagh,34,NSH,D,74,3,29,32,19,31
Darnell Nurse,28,EDM,D,81,10,22,32,3,79
Ivan Provorov,27,CBJ,D,82,5,27,32,-11,20
Cole Sillinger,20,CBJ,C,77,13,19,32,-4,46
Dylan DeMelo,30,WPG,D,82,3,28,31,46,36
Lars Eller,34,PIT,C,82,15,16,31,-1,32
Brendan Gallagher,31,MTL,RW,77,16,15,31,-24,74
Erik Gustafsson,31,NYR,D,76,6,25,31,3,35
Tyler Johnson,33,CHI,C,67,17,14,31,-35,26
Seth Jones,29,CHI,D,67,8,23,31,-15,34
Ilya Mikheyev,29,VAN,F,78,11,20,31,1,4
Ondřej Palát,32,NJD,LW,71,11,20,31,-9,37
Zach Benson,18,BUF,LW,71,11,19,30,-3,36
Thomas Chabot,27,OTT,D,51,9,21,30,-3,22
Ryan Donato,27,CHI,C,78,12,18,30,-14,26
Justin Faulk,31,STL,D,60,2,28,30,-2,39
Marcus Johansson,33,MIN,C,78,11,19,30,-15,22
Ryan McLeod,24,EDM,C,81,12,18,30,10,10
K'Andre Miller,24,NYR,D,80,8,22,30,5,49
Joshua Norris,24,OTT,C,50,16,14,30,-6,22
Marcus Pettersson,27,PIT,D,82,4,26,30,28,44
Jaden Schwartz,31,SEA,C,62,13,17,30,-15,24
Jordan Staal,35,CAR,C,80,10,20,30,-14,44
Alexandre Texier,24,CBJ,C,78,12,18,30,-5,38
Cameron York,23,PHI,D,82,10,20,30,-13,44
Michael Carcone,27,ARI,F,74,21,8,29,-2,35
Leo Carlsson,19,ANA,C,55,12,17,29,-11,16
Yegor Chinakhov,22,CBJ,RW,53,16,13,29,-3,6
Kevin Hayes,31,STL,RW,79,13,16,29,0,12
Tyler Myers,33,VAN,D,77,5,24,29,16,77
Aliaksei Protas,23,WSH,C,78,6,23,29,-3,8
Pius Suter,27,VAN,F,67,14,15,29,17,16
Cam Atkinson,34,PHI,RW,70,13,15,28,-22,27
Teddy Blueger,29,VAN,C,68,6,22,28,4,31
Pierre Engvall,27,NYI,LW,74,10,18,28,4,18
Jake Evans,27,MTL,C,82,7,21,28,-1,24
Jordan Greenway,26,BUF,LW,67,10,18,28,11,64
Alexander Holtz,22,NJD,RW,82,16,12,28,-15,14
Nick Leddy,32,STL,D,82,3,25,28,14,14
Jake McCabe,30,TOR,D,73,8,20,28,20,56
Pavel Mintyukov,20,ANA,D,63,4,24,28,-20,24
Ryan Poehling,25,PHI,C,77,11,17,28,-11,6
Damon Severson,29,CBJ,D,67,9,19,28,-10,51
Joe Veleno,24,DET,C,80,12,16,28,-16,25
Michael Amadio,27,VEG,C,73,14,13,27,4,16
Jonas Brodin,30,MIN,D,62,7,20,27,22,16
Jack Drury,23,CAR,C,74,8,19,27,4,33
Anthony Duclair,28,2TM,LW,73,24,18,42,-8,34
Anthony Duclair,28,SJS,LW,56,16,11,27,-12,28
Anthony Duclair,28,TBL,LW,17,8,7,15,4,6
Adam Fantilli,19,CBJ,C,49,12,15,27,-21,16
Alex Iafallo,30,WPG,C,82,11,16,27,14,6
Jesperi Kotkaniemi,23,CAR,C,79,12,15,27,-4,36
Eetu Luostarinen,25,FLA,C,82,12,15,27,1,26
Shane Pinto,23,OTT,C,41,9,18,27,9,14
Nicholas Robertson,22,TOR,LW,56,14,13,27,4,4
Kiefer Sherwood,28,NSH,RW,68,10,17,27,17,41
T.J. Brodie,33,TOR,D,78,1,25,26,17,40
Justin Danforth,30,CBJ,RW,71,10,16,26,-10,26
Ridly Greig,21,OTT,C,72,13,13,26,10,66
Erik Gudbranson,32,CBJ,D,78,6,20,26,-14,74
Esa Lindell,29,DAL,D,82,5,21,26,17,12
Hampus Lindholm,30,BOS,D,73,3,23,26,18,63
Jack McBain,24,ARI,C,67,8,18,26,8,50
Brayden McNabb,33,VEG,D,82,4,22,26,18,37
J.J. Moser,23,ARI,D,80,5,21,26,-5,35
Dmitry Orlov,32,CAR,D,82,6,20,26,4,36
Colton Parayko,30,STL,D,82,10,16,26,4,23
Justin Schultz,33,SEA,D,70,7,19,26,-23,22
Jimmy Vesey,30,NYR,LW,80,13,13,26,-4,20
Miles Wood,28,COL,LW,74,9,17,26,-5,75
Joel Armia,30,MTL,RW,66,17,8,25,4,34
William Borgen,27,SEA,D,82,3,22,25,-5,65
Cody Ceci,30,EDM,D,79,5,20,25,12,14
Paul Cotter,24,VEG,C,76,7,18,25,-11,41
Michael Eyssimont,27,TBL,C,81,11,14,25,7,104
Simon Holmström,22,NYI,RW,75,15,10,25,2,14
Andrei Kuzmenko,27,2TM,F,72,22,24,46,-9,12
Andrei Kuzmenko,27,CGY,F,29,14,11,25,-8,6
Andrei Kuzmenko,27,VAN,F,43,8,13,21,-1,6
Curtis Lazar,28,NJD,C,71,7,18,25,10,44
Josh Manson,32,COL,D,76,8,17,25,11,87
John Marino,26,NJD,D,75,4,21,25,-6,41
Jacob Middleton,28,MIN,D,80,7,18,25,-15,77
Logan O'Connor,27,COL,RW,57,13,12,25,13,34
T.J. Oshie,37,WSH,C,52,12,13,25,-6,44
Matt Roy,28,LAK,D,81,5,20,25,21,42
Alexander Wennberg,29,2TM,C,79,10,20,30,0,14
Alexander Wennberg,29,SEA,C,60,9,16,25,1,14
Alexander Wennberg,29,NYR,C,19,1,4,5,-1,0
Artem Zub,28,OTT,D,69,5,20,25,5,32
Jason Zucker,32,2TM,LW,69,14,18,32,-9,81
Jason Zucker,32,ARI,LW,51,9,16,25,-5,58
Jason Zucker,32,NSH,LW,18,5,2,7,-4,23
Pavel Dorofeyev,23,VEG,LW,47,13,11,24,8,12
Sam Lafferty,28,VAN,C,79,13,11,24,4,32
Bobby McMann,27,TOR,F,56,15,9,24,13,52
Nicklaus Perbix,25,TBL,D,77,2,22,24,8,10
Jeff Petry,36,DET,D,73,3,21,24,-7,39
Martin Pospisil,24,CGY,C,63,8,16,24,14,109
Mike Reilly,30,2TM,D,61,6,18,24,-1,30
Mike Reilly,30,NYI,D,59,6,18,24,1,28
Mike Reilly,30,FLA,D,2,0,0,0,-2,2
David Savard,33,MTL,D,60,6,18,24,-1,24
Kevin Shattenkirk,35,BOS,D,61,6,18,24,-2,18
Jordan Spence,22,LAK,D,71,2,22,24,5,12
Sam Steel,25,DAL,C,77,9,15,24,0,29
Bobby Brink,22,PHI,RW,57,11,12,23,1,10
Casey Cizikas,32,NYI,C,70,10,13,23,-2,22
Evgenii Dadonov,34,DAL,RW,51,12,11,23,-6,8
Vladislav Gavrikov,28,LAK,D,77,6,17,23,9,28
Mike Hoffman,34,SJS,C,66,10,13,23,-21,20
Ryan Johansen,31,COL,C,63,13,10,23,-6,34
Alex Laferriere,22,LAK,RW,81,12,11,23,-14,46
Timothy Liljegren,24,TOR,D,55,3,20,23,3,16
Sonny Milano,27,WSH,LW,49,15,8,23,4,10
Max Pacioretty,35,WSH,LW,47,4,19,23,-14,25
Jack Roslovic,27,2TM,C,59,9,22,31,-10,16
Jack Roslovic,27,CBJ,C,40,6,17,23,-9,14
Jack Roslovic,27,NYR,C,19,3,5,8,-1,2
Rasmus Sandin,23,WSH,D,68,3,20,23,-13,24
Cole Smith,28,NSH,F,80,9,14,23,5,63
Filip Zadina,24,SJS,RW,72,13,10,23,-44,18
Jalen Chatfield,27,CAR,D,72,8,14,22,15,24
Nic Dowd,33,WSH,C,64,12,10,22,-2,47
Marcus Foligno,32,MIN,LW,55,10,12,22,10,59
Kaiden Guhle,22,MTL,D,70,6,16,22,-8,56
Kasperi Kapanen,27,STL,RW,73,6,16,22,-5,14
Hendrix Lapierre,21,WSH,C,51,8,14,22,-1,4
Brett Leason,24,ANA,RW,68,11,11,22,-7,14
Michael McCarron,28,NSH,RW,70,12,10,22,4,100
Kyle Okposo,35,2TM,RW,67,12,10,22,1,34
Kyle Okposo,35,BUF,RW,61,12,10,22,1,32
Kyle Okposo,35,FLA,RW,6,0,0,0,0,2
Alexander Romanov,24,NYI,D,81,7,15,22,23,20
Jacob Trouba,29,NYR,D,69,3,19,22,-4,73
Sean Walker,29,2TM,D,81,10,19,29,11,50
Sean Walker,29,PHI,D,63,6,16,22,9,34
Sean Walker,29,COL,D,18,4,3,7,2,16
William Cuylle,21,NYR,LW,81,13,8,21,-3,56
Mario Ferraro,25,SJS,D,78,3,18,21,-38,36
Calle Järnkrok,32,TOR,C,52,10,11,21,16,18
Michael Kesselring,24,ARI,D,65,5,16,21,11,66
Beck Malenstyn,25,WSH,LW,81,6,15,21,-1,25
Oskar Sundqvist,29,STL,C,71,6,15,21,-6,32
Alexey Toropchenko,24,STL,RW,82,14,7,21,-3,30
Jake Walman,27,DET,D,63,12,9,21,-2,44
Blake Wheeler,37,NYR,RW,54,9,12,21,2,23
Yegor Zamula,23,PHI,D,66,5,16,21,3,32
Josh Anderson,29,MTL,RW,78,9,11,20,-18,74
Erik Brännström,24,OTT,D,76,3,17,20,5,36
Bowen Byram,22,2TM,D,73,11,18,29,0,53
Bowen Byram,22,COL,D,55,8,12,20,1,40
Bowen Byram,22,BUF,D,18,3,6,9,-1,13
Alexandre Carrier,27,NSH,D,73,4,16,20,7,44
Ben Chiarot,32,DET,D,77,5,15,20,-4,56
Brenden Dillon,33,WPG,D,77,8,12,20,20,92
Henri Jokiharju,24,BUF,D,74,3,17,20,14,24
Tye Kartye,22,SEA,F,77,11,9,20,-1,37
Dmitry Kulikov,33,FLA,D,76,1,19,20,15,63
Valtteri Puustinen,24,PIT,RW,52,5,15,20,4,6
Craig Smith,34,DAL,C,75,11,9,20,2,33
Philip Tomasino,22,NSH,C,41,7,13,20,-6,25
Jonny Brodzinski,30,NYR,C,57,6,13,19,-3,8
Cal Clutterbuck,36,NYI,RW,82,7,12,19,4,32
Andrew Cogliano,36,COL,LW,75,6,13,19,11,16
Radek Faksa,30,DAL,C,74,7,12,19,0,20
Jesper Fast,32,CAR,RW,73,6,13,19,0,16
Christian Fischer,26,DET,RW,79,5,14,19,0,36
Brett Howden,25,VEG,C,72,8,11,19,-11,39
Kaapo Kakko,22,NYR,RW,61,13,6,19,6,24
David Kämpf,29,TOR,C,78,8,11,19,-4,18
Nils Lundkvist,23,DAL,D,59,2,17,19,13,16
Michael McLeod,25,NJD,C,45,10,9,19,6,10
Simon Nemec,19,NJD,D,60,3,16,19,-7,33
Ryan Pulock,29,NYI,D,58,5,14,19,3,12
Jack Quinn,22,BUF,RW,27,9,10,19,-1,8
Jan Rutta,33,SJS,D,69,5,14,19,-21,38
Braden Schneider,22,NYR,D,82,5,14,19,-1,16
Mikhail Sergachev,25,TBL,D,34,2,17,19,-16,16
Jakob Silfverberg,33,ANA,LW,81,7,12,19,4,24
Michael Anderson,24,LAK,D,74,2,16,18,22,18
Morgan Barron,25,WPG,C,80,11,7,18,10,23
Noah Cates,24,PHI,LW,59,6,12,18,-8,0
Connor Clifton,28,BUF,D,79,4,14,18,12,88
Aaron Ekblad,27,FLA,D,51,4,14,18,27,50
Samuel Girard,25,COL,D,59,3,15,18,0,10
Radko Gudas,33,ANA,D,66,6,12,18,14,128
Parker Kelly,24,OTT,F,80,8,10,18,-8,30
Keegan Kolesar,26,VEG,RW,79,8,10,18,-8,49
Luke Kunin,26,SJS,C,77,11,7,18,-30,83
Sean Kuraly,31,CBJ,C,62,9,9,18,-5,40
Adam Larsson,31,SEA,D,81,4,14,18,6,55
Olli Määttä,29,DET,D,72,4,14,18,14,14
Dylan Samberg,25,WPG,D,78,1,17,18,16,43
Joey Anderson,25,CHI,RW,55,5,12,17,5,8
Garnet Hathaway,32,PHI,RW,82,7,10,17,-7,132
Pontus Holmberg,24,TOR,RW,54,7,10,17,11,18
Peyton Krebs,23,BUF,C,80,4,13,17,2,67
Evgeny Kuznetsov,31,2TM,C,63,8,16,24,-11,30
Evgeny Kuznetsov,31,WSH,C,43,6,11,17,-11,24
Evgeny Kuznetsov,31,CAR,C,20,2,5,7,0,6
Jackson LaCombe,23,ANA,D,71,2,15,17,-24,24
Ryan Lindgren,25,NYR,D,76,3,14,17,22,36
Alec Martinez,36,VEG,D,55,4,13,17,-2,6
Niko Mikkola,27,FLA,D,82,3,14,17,11,69
Scott Perunovich,25,STL,D,54,0,17,17,1,12
Ryan Suter,39,DAL,D,82,2,15,17,14,28
Juuso Välimäki,25,ARI,D,68,2,15,17,12,12
Nicolas Aubé-Kubel,27,WSH,RW,60,6,10,16,4,23
André Burakovsky,28,SEA,LW,49,7,9,16,-15,14
Brian Dumoulin,32,SEA,D,80,6,10,16,3,20
Martin Fehérváry,24,WSH,D,66,3,13,16,-7,24
Dougie Hamilton,30,NJD,D,20,5,11,16,-8,20
Jack Johnson,37,COL,D,80,3,13,16,15,38
Kent Johnson,21,CBJ,C,42,6,10,16,-2,10
Brett Kulak,30,EDM,D,82,3,13,16,0,30
Trevor Lewis,37,LAK,C,82,8,8,16,7,20
Pat Maroon,35,2TM,LW,51,4,12,16,-11,60
Pat Maroon,35,MIN,LW,49,4,12,16,-11,60
Pat Maroon,35,BOS,LW,2,0,0,0,0,0
Adam Pelech,29,NYI,D,58,1,15,16,-2,27
Lukas Reichel,21,CHI,LW,65,5,11,16,-29,12
Brandon Tanev,32,SEA,LW,66,7,9,16,2,51
Alex Vlasic,22,CHI,D,76,2,14,16,-4,45
Kailer Yamamoto,25,SEA,RW,59,8,8,16,-9,18
Viktor Arvidsson,30,LAK,LW,18,6,9,15,4,14
Tyson Barrie,32,NSH,D,41,1,14,15,-10,16
Jeff Carter,39,PIT,C,72,11,4,15,-7,12
Nick Cousins,30,FLA,C,69,7,8,15,1,64
Frédérick Gaudreau,30,MIN,C,67,5,10,15,-23,12
Mark Jankowski,29,NSH,C,32,7,8,15,11,8
Max Jones,25,ANA,LW,52,5,10,15,-6,33
Arthur Kaliyev,22,LAK,RW,51,7,8,15,-3,14
Kevin Korchinski,19,CHI,D,76,5,10,15,-39,20
Dominik Kubalík,28,OTT,LW,74,11,4,15,-30,19
Blake Lizotte,26,LAK,C,62,7,8,15,11,20
Alexander Nylander,25,2TM,LW,28,11,4,15,-1,6
Alexander Nylander,25,CBJ,LW,23,11,4,15,-1,6
Alexander Nylander,25,PIT,LW,5,0,0,0,0,0
Jamie Oleksiak,31,SEA,D,82,2,13,15,-2,37
Victor Olofsson,28,BUF,RW,51,7,8,15,-1,4
Matthew Poitras,19,BOS,C,33,5,10,15,4,6
Conor Sheary,31,TBL,LW,57,4,11,15,-3,12
Brendan Smith,34,NJD,D,63,5,10,15,-3,61
Kevin Stenlund,27,FLA,C,81,11,4,15,-10,62
Tomáš Tatar,33,2TM,LW,70,9,15,24,8,20
Tomáš Tatar,33,SEA,LW,43,8,7,15,8,10
Tomáš Tatar,33,COL,LW,27,1,8,9,0,10
Trevor Zegras,22,ANA,C,31,6,9,15,-1,30
Justin Bailey,28,SJS,RW,59,5,9,14,-15,6
Jacob Bernard-Docker,23,OTT,D,72,4,10,14,-7,25
Zach Bogosian,33,2TM,D,65,3,11,14,11,63
Zach Bogosian,33,MIN,D,61,3,11,14,11,63
Zach Bogosian,33,TBL,D,4,0,0,0,0,0
Jesper Boqvist,25,BOS,C,47,6,8,14,12,8
Brandon Carlo,27,BOS,D,76,4,10,14,23,42
Connor Dewar,24,2TM,C,74,11,8,19,-8,28
Connor Dewar,24,MIN,C,57,10,4,14,-6,20
Connor Dewar,24,TOR,C,17,1,4,5,-2,8
Hudson Fasching,28,NYI,RW,45,4,10,14,-7,6
Zemgus Girgensons,30,BUF,C,63,8,6,14,-1,21
Ryan Graves,28,PIT,D,70,3,11,14,10,30
Jordan Harris,23,MTL,D,56,3,11,14,-5,22
Tanner Jeannot,26,TBL,F,55,7,7,14,-10,75
Nick Jensen,33,WSH,D,78,1,13,14,-9,10
Jeremy Lauzon,26,NSH,D,79,6,8,14,-3,98
Liam O'Brien,29,ARI,C,75,5,9,14,0,153
Taylor Raddysh,25,CHI,RW,73,5,9,14,-19,22
Nate Schmidt,32,WPG,D,63,2,12,14,10,16
Logan Stankoven,20,DAL,C,24,6,8,14,10,4
Chris Tanev,34,2TM,D,75,2,17,19,22,24
Chris Tanev,34,CGY,D,56,1,13,14,16,14
Chris Tanev,34,DAL,D,19,1,4,5,6,10
Yakov Trenin,27,2TM,C,76,12,5,17,15,40
Yakov Trenin,27,NSH,C,60,10,4,14,12,38
Yakov Trenin,27,COL,C,16,2,1,3,3,2
Urho Vaakanainen,25,ANA,D,68,1,13,14,0,26
Trevor van Riemsdyk,32,WSH,D,70,0,14,14,-7,18
Zach Whitecloud,27,VEG,D,61,2,12,14,-3,32
Nikita Zadorov,28,2TM,D,75,6,14,20,0,125
Nikita Zadorov,28,VAN,D,54,5,9,14,6,102
Nikita Zadorov,28,CGY,D,21,1,5,6,-6,23
Alexander Barabanov,29,SJS,F,46,4,9,13,-24,12
Justin Barron,22,MTL,D,48,7,6,13,-3,16
Jake Bean,25,CBJ,D,72,4,9,13,-10,32
Erik Černák,26,TBL,D,69,2,11,13,5,63
Dante Fabbro,25,NSH,D,56,3,10,13,9,24
Cody Glass,24,NSH,C,41,6,7,13,-9,20
Johnathan Kovacevic,26,MTL,D,62,6,7,13,11,42
Mason Lohrei,23,BOS,D,41,4,9,13,-2,18
Tanner Pearson,31,MTL,LW,54,5,8,13,-12,21
Corey Perry,38,2TM,RW,54,12,10,22,-6,46
Corey Perry,38,EDM,RW,38,8,5,13,-1,34
Corey Perry,38,CHI,RW,16,4,5,9,-5,12
Brett Pesce,29,CAR,D,70,3,10,13,10,20
Nick Seeler,30,PHI,D,71,1,12,13,9,78
Nico Sturm,28,SJS,C,63,5,8,13,-25,12
Nathan Walker,29,STL,C,45,7,6,13,-1,18
Calen Addison,23,2TM,D,72,1,16,17,-38,72
Calen Addison,23,SJS,D,60,1,11,12,-35,66
Calen Addison,23,MIN,D,12,0,5,5,-3,6
Nathan Bastian,26,NJD,RW,54,5,7,12,-10,32
Colin Blackwell,30,CHI,C,44,8,4,12,-2,10
Connor Brown,30,EDM,RW,71,4,8,12,-8,10
Ryan Carpenter,33,SJS,C,62,5,7,12,-16,6
Barclay Goodrow,30,NYR,RW,80,4,8,12,-13,78
A.J. Greer,27,CGY,LW,59,6,6,12,-7,35
Noah Gregor,25,TOR,C,63,6,6,12,-7,17
Carl Grundström,26,LAK,RW,50,8,4,12,-2,12
Nicolas Hague,25,VEG,D,73,2,10,12,-5,43
Jani Hakanpää,31,DAL,D,64,2,10,12,10,33
Mattias Janmark,31,EDM,C,71,4,8,12,0,46
Mathieu Olivier,26,CBJ,F,54,5,7,12,-4,70
Juuso Pärssinen,22,NSH,C,44,8,4,12,-6,12
Michael Pezzetta,25,MTL,C,61,3,9,12,4,59
Derek Ryan,37,EDM,C,70,5,7,12,-3,8
Chris Tierney,29,NJD,C,52,4,8,12,3,21
Marc-Édouard Vlasic,36,SJS,D,57,6,6,12,-27,26
Kevin Bahl,23,NJD,D,82,1,10,11,1,82
Emil Bemström,24,2TM,C,56,8,8,16,-5,12
Emil Bemström,24,CBJ,C,32,5,6,11,-5,10
Emil Bemström,24,PIT,C,24,3,2,5,0,2
Thomas Bordeleau,22,SJS,C,27,6,5,11,-18,18
Sam Carrick,31,2TM,C,77,10,6,16,-11,102
Sam Carrick,31,ANA,C,61,8,3,11,-11,90
Sam Carrick,31,EDM,C,16,2,3,5,0,12
Ian Cole,34,VAN,D,78,2,9,11,10,61
Tony DeAngelo,28,CAR,D,31,3,8,11,-7,24
Vincent Desharnais,27,EDM,D,78,1,10,11,3,54
MacKenzie Entwistle,24,CHI,RW,67,5,6,11,-29,47
Luke Glendening,34,TBL,C,81,10,1,11,-2,39
Matt Grzelcyk,30,BOS,D,63,2,9,11,13,37
Pierre-Olivier Joseph,24,PIT,D,52,2,9,11,-3,14
Isac Lundeström,24,ANA,C,46,5,6,11,-1,2
Jonathon Merrill,31,MIN,D,65,4,7,11,0,30
Henry Thrun,22,SJS,D,51,3,8,11,-22,16
John Beecher,22,BOS,C,52,7,3,10,-6,24
Adam Boqvist,23,CBJ,D,35,1,9,10,-8,0
Josh Brown,30,ARI,D,51,3,7,10,2,75
Calvin de Haan,32,TBL,D,59,3,7,10,-9,22
Phillip Di Giuseppe,30,VAN,LW,51,5,5,10,-1,36
Mathew Dumba,29,2TM,D,76,4,8,12,-18,88
Mathew Dumba,29,ARI,D,58,4,6,10,-13,55
Mathew Dumba,29,TBL,D,18,0,2,2,-5,33
Ty Emberson,23,SJS,D,30,1,9,10,-4,6
Andreas Englund,28,LAK,D,82,1,9,10,-3,81
Sam Gagner,34,EDM,C,28,5,5,10,-2,10
Alex Goligoski,38,MIN,D,36,0,10,10,-8,18
Rafaël Harvey-Pinard,25,MTL,LW,45,2,8,10,-2,6
Barrett Hayton,23,ARI,C,33,3,7,10,-13,26
Ben Hutton,30,VEG,D,41,2,8,10,12,17
David Jiříček,20,CBJ,D,43,1,9,10,-4,22
Mark Kastelic,24,OTT,C,63,5,5,10,-5,63
Klim Kostin,24,2TM,C,52,8,6,14,-12,53
Klim Kostin,24,SJS,C,19,5,5,10,-10,15
Klim Kostin,24,DET,C,33,3,1,4,-2,38
Jakub Lauko,23,BOS,C,60,2,8,10,-3,32
Sam Malinski,25,COL,D,23,3,7,10,3,6
Zach Parise,39,COL,LW,30,5,5,10,-7,8
Jayden Struble,22,MTL,D,56,3,7,10,-3,57
Conor Timmins,25,TOR,D,25,1,9,10,9,18
Arber Xhekaj,23,MTL,D,44,3,7,10,6,81
Sebastian Aho,27,NYI,D,58,2,7,9,-7,12
Andreas Athanasiou,29,CHI,C,28,2,7,9,-7,7
Alex Barré-Boulet,26,TBL,F,36,6,3,9,-9,10
Zachary Bolduc,20,STL,C,25,5,4,9,0,6
Matthew Coronato,21,CGY,RW,34,3,6,9,-15,4
Ty Dellandrea,23,DAL,C,42,2,7,9,-10,23
Josh Doan,21,ARI,RW,11,5,4,9,6,0
Christian Dvorak,27,MTL,C,30,5,4,9,-5,4
Ryker Evans,22,SEA,D,36,1,8,9,-5,20
Julien Gauthier,26,NYI,RW,27,5,4,9,-5,8
Mark Giordano,40,TOR,D,46,3,6,9,10,49
Dylan Holloway,22,EDM,C,38,6,3,9,-1,29
Zachary Jones,23,NYR,D,31,2,7,9,1,8
Boris Katchouk,25,2TM,LW,59,7,6,13,-6,12
Boris Katchouk,25,CHI,LW,38,5,4,9,-2,12
Boris Katchouk,25,OTT,LW,21,2,2,4,-4,0
Joel Kiviranta,27,COL,F,56,3,6,9,-1,12
Kaedan Korczak,23,VEG,D,26,1,8,9,12,8
Kevin Labanc,28,SJS,RW,46,2,7,9,-27,16
Patrik Laine,25,CBJ,RW,18,6,3,9,-10,6
Vinni Lettieri,28,MIN,C,46,5,4,9,-7,24
Jacob MacDonald,30,SJS,D,34,7,2,9,-14,23
Kyle MacLean,24,NYI,F,32,4,5,9,5,11
Josh Mahura,25,FLA,D,30,0,9,9,-2,20
Tyler Motte,28,TBL,C,69,6,3,9,-8,28
Fredrik Olofsson,27,COL,LW,57,3,6,9,-5,8
Eric Robinson,28,2TM,LW,47,3,7,10,-3,19
Eric Robinson,28,BUF,LW,40,2,7,9,0,19
Eric Robinson,28,CBJ,LW,7,1,0,1,-3,0
Joshua Roy,20,MTL,RW,23,4,5,9,-2,0
Adam Ružička,24,2TM,C,42,3,6,9,-9,12
Adam Ružička,24,CGY,C,39,3,6,9,-8,6
Adam Ružička,24,ARI,C,3,0,0,0,-1,6
Jonas Siegenthaler,26,NJD,D,57,1,8,9,-7,20
Jarred Tinordi,31,CHI,D,52,0,9,9,-27,64
Olen Zellweger,20,ANA,D,26,2,7,9,-6,4
Anthony Beauvillier,26,3TM,LW,60,5,12,17,-8,8
Anthony Beauvillier,26,VAN,LW,22,2,6,8,8,4
Anthony Beauvillier,26,CHI,LW,23,2,4,6,-10,2
Anthony Beauvillier,26,NSH,LW,15,1,2,3,-6,2
Travis Boyd,30,ARI,C,16,2,6,8,3,2
Brendan Brisson,22,VEG,C,15,2,6,8,-5,2
Jacob Bryson,26,BUF,D,36,1,7,8,5,8
Kyle Burroughs,28,SJS,D,73,2,6,8,-42,71
William Carrier,29,VEG,LW,39,6,2,8,3,16
Declan Chisholm,24,2TM,D,31,3,6,9,-7,18
Declan Chisholm,24,MIN,D,29,3,5,8,-8,18
Declan Chisholm,24,WPG,D,2,0,1,1,1,0
Brandon Duhaime,26,2TM,RW,80,5,8,13,-5,70
Brandon Duhaime,26,MIN,RW,62,4,4,8,-7,66
Brandon Duhaime,26,COL,RW,18,1,4,5,2,4
Cole Guttman,24,CHI,C,27,4,4,8,-17,7
Dryden Hunt,28,CGY,LW,28,3,5,8,1,7
Oliver Kylington,26,CGY,D,33,3,5,8,-6,12
Matt Martin,34,NYI,LW,57,4,4,8,7,43
Dakota Mermis,30,MIN,D,47,3,5,8,-2,33
Colin Miller,31,2TM,D,46,4,5,9,8,26
Colin Miller,31,NJD,D,41,4,4,8,10,24
Colin Miller,31,WPG,D,5,0,1,1,-2,2
Connor Murphy,30,CHI,D,46,2,6,8,-19,40
Nikita Okhotyuk,23,2TM,D,52,1,8,9,-24,48
Nikita Okhotyuk,23,SJS,D,43,1,7,8,-22,44
Nikita Okhotyuk,23,CGY,D,9,0,1,1,-2,4
Andrew Peeke,25,2TM,D,38,1,9,10,-1,14
Andrew Peeke,25,CBJ,D,23,1,7,8,-2,6
Andrew Peeke,25,BOS,D,15,0,2,2,1,8
Marco Scandella,33,STL,D,65,2,6,8,2,15
Parker Wotherspoon,26,BOS,D,41,0,8,8,6,31
Jesse Ylönen,24,MTL,RW,59,4,4,8,2,12
Noel Acciari,32,PIT,C,55,4,3,7,-7,10
Nils Åman,23,VAN,C,43,3,4,7,-3,8
Pierre-Édouard Bellemare,38,SEA,LW,40,4,3,7,4,6
Sammy Blais,27,STL,LW,53,1,6,7,-11,31
Justin Brazeau,25,BOS,F,19,5,2,7,4,2
Mitchell Chaffee,26,TBL,F,30,4,3,7,2,4
Travis Dermott,27,ARI,D,50,2,5,7,-14,26
Dillon Dubé,25,CGY,C,43,3,4,7,-13,8
Walker Duehr,26,CGY,F,40,2,5,7,-3,6
Dennis Gilbert,27,CGY,D,34,1,6,7,-7,16
David Gustafsson,23,WPG,C,39,3,4,7,1,0
Ryan Johnson,22,BUF,D,41,0,7,7,3,12
Noah Juulsen,26,VAN,D,54,1,6,7,-1,22
Wyatt Kaiser,21,CHI,D,32,0,7,7,0,22
Matthew Kessel,23,STL,D,39,1,6,7,0,12
Ryan Lomberg,29,FLA,LW,75,5,2,7,-1,80
Daniil Miromanov,26,2TM,D,24,3,4,7,-2,8
Daniil Miromanov,26,CGY,D,20,3,4,7,0,8
Daniil Miromanov,26,VEG,D,4,0,0,0,-2,0
Mattias Samuelsson,23,BUF,D,41,1,6,7,4,26
Luke Schenn,34,NSH,D,63,1,6,7,1,43
Michael Sgarbossa,31,WSH,C,25,4,3,7,0,2
Nikita Zaitsev,32,CHI,D,38,2,5,7,-5,14
Radim Zohorna,27,PIT,F,33,4,3,7,0,18
Jonatan Berggren,23,DET,RW,12,2,4,6,-1,2
Filip Chytil,24,NYR,C,10,0,6,6,0,4
Brandt Clarke,20,LAK,D,16,2,4,6,-6,10
Joel Edmundson,30,2TM,D,53,1,5,6,-2,23
Joel Edmundson,30,WSH,D,44,1,5,6,-5,19
Joel Edmundson,30,TOR,D,9,0,0,0,3,4
Travis Hamonic,33,OTT,D,48,2,4,6,-10,40
Tyson Jost,25,BUF,C,43,3,3,6,-11,10
Gustav Lindström,25,2TM,D,46,3,7,10,12,24
Gustav Lindström,25,ANA,D,32,0,6,6,12,18
Gustav Lindström,25,MTL,D,14,3,1,4,0,6
Ivan Miroshnichenko,19,WSH,LW,21,2,4,6,-4,6
Tomáš Nosek,31,NJD,C,36,2,4,6,-11,6
Brayden Pachal,24,2TM,D,50,2,5,7,-3,51
Brayden Pachal,24,CGY,D,33,1,5,6,-1,39
Brayden Pachal,24,VEG,D,17,1,0,1,-2,12
Isaak Phillips,22,CHI,D,33,0,6,6,-26,22
Ryan Reaves,37,TOR,RW,49,4,2,6,-13,49
Carson Soucy,29,VAN,D,40,2,4,6,10,12
Jakub Vrána,27,STL,LW,21,2,4,6,-7,8
Oliver Wahlstrom,23,NYI,RW,32,2,4,6,-6,8
Simon Benoit,25,TOR,D,64,1,4,5,7,56
Samuel Bolduc,23,NYI,D,34,2,3,5,-4,6
Nick Bonino,35,NYR,C,45,1,4,5,-12,8
Nick DeSimone,29,2TM,D,34,2,5,7,3,4
Nick DeSimone,29,CGY,D,23,1,4,5,-4,2
Nick DeSimone,29,NJD,D,11,1,1,2,7,2
Jamie Drysdale,21,2TM,D,34,3,7,10,-20,8
Jamie Drysdale,21,ANA,D,10,1,4,5,-2,4
Jamie Drysdale,21,PHI,D,24,2,3,5,-18,4
Haydn Fleury,27,TBL,D,24,1,4,5,5,20
Justin Holl,32,DET,D,38,0,5,5,8,22
Reese Johnson,25,CHI,F,42,2,3,5,-20,40
Caleb Jones,26,COL,D,25,0,5,5,4,8
Axel Jonsson-Fjällby,25,WPG,LW,26,2,3,5,6,0
John Klingberg,31,TOR,D,14,0,5,5,-7,8
Brendan Lemieux,27,CAR,LW,32,3,2,5,0,64
Jake Lucchini,28,MIN,F,40,2,3,5,-3,23
John Ludvig,23,PIT,D,33,3,2,5,-12,47
Olle Lycksell,24,PHI,RW,18,1,4,5,0,6
Jacob Markström,34,CGY,G,48,0,5,5,0,0
Emil Martinsen Lilleberg,22,TBL,D,37,0,5,5,-15,16
Scott Mayfield,31,NYI,D,41,0,5,5,-7,35
Matthew Phillips,25,2TM,F,31,1,4,5,-3,0
Matthew Phillips,25,WSH,F,28,1,4,5,-3,0
Matthew Phillips,25,PIT,F,3,0,0,0,0,0
Jared Spurgeon,34,MIN,D,16,0,5,5,5,2
Marc Staal,37,PHI,D,35,1,4,5,2,14
Troy Stecher,29,2TM,D,54,1,6,7,9,32
Troy Stecher,29,ARI,D,47,1,4,5,5,24
Troy Stecher,29,EDM,D,7,0,2,2,4,8
Dominic Toninato,29,WPG,C,15,1,4,5,7,6
Shane Wright,20,SEA,C,8,4,1,5,1,0
Jaret Anderson-Dolan,24,2TM,C,31,1,3,4,-5,6
Jaret Anderson-Dolan,24,LAK,C,30,1,3,4,-4,6
Jaret Anderson-Dolan,24,NSH,C,1,0,0,0,-1,0
Ethan Bear,26,WSH,D,24,1,3,4,-5,10
Louis Belpedio,27,PHI,D,12,2,2,4,6,0
Nicolas Deslauriers,32,PHI,LW,60,1,3,4,-7,89
Derek Forbort,31,BOS,D,35,0,4,4,8,17
Jonah Gadjovich,25,FLA,LW,39,2,2,4,0,104
Brendan Gaunce,29,CBJ,C,24,2,2,4,-7,6
Taylor Hall,32,CHI,LW,10,2,2,4,-3,4
Jansen Harkins,26,PIT,C,45,0,4,4,-4,21
Ross Johnston,29,ANA,LW,68,1,3,4,-12,117
Marat Khusnutdinov,21,MIN,C,16,1,3,4,-3,6
Vladislav Kolyachonok,22,ARI,D,5,1,3,4,5,2
William Lagesson,27,2TM,D,40,0,4,4,3,32
William Lagesson,27,TOR,D,30,0,4,4,5,19
William Lagesson,27,ANA,D,10,0,0,0,-2,13
Ilya Lyubushkin,29,2TM,D,74,0,8,8,-11,57
Ilya Lyubushkin,29,ANA,D,55,0,4,4,-13,51
Ilya Lyubushkin,29,TOR,D,19,0,4,4,2,6
James Malatesta,20,CBJ,LW,11,2,2,4,-1,5
Mason Morelli,27,VEG,F,9,3,1,4,-3,0
Matthew Nieto,31,PIT,LW,22,1,3,4,5,4
Tyler Pitlick,32,NYR,C,34,1,3,4,-6,4
Jesse Puljujärvi,25,PIT,RW,22,3,1,4,2,6
Rasmus Ristolainen,29,PHI,D,31,1,3,4,-6,8
Kevin Rooney,30,CGY,C,33,3,1,4,-4,2
Chad Ruhwedel,33,2TM,D,52,1,3,4,-6,4
Chad Ruhwedel,33,PIT,D,47,1,3,4,-4,4
Chad Ruhwedel,33,NYR,D,5,0,0,0,-2,0
Zach Sanford,29,2TM,LW,29,0,6,6,0,6
Zach Sanford,29,CHI,LW,18,0,4,4,-3,2
Zach Sanford,29,ARI,LW,11,0,2,2,3,4
Devin Shore,29,SEA,C,21,1,3,4,3,4
Landon Slaggert,21,CHI,LW,16,1,3,4,1,4
Givani Smith,25,SJS,RW,36,1,3,4,-13,40
Spencer Stastney,24,NSH,D,20,2,2,4,9,4
Akil Thomas,24,LAK,C,7,3,1,4,0,2
Alex Turcotte,22,LAK,C,20,1,3,4,5,6
Austin Watson,32,TBL,LW,33,2,2,4,2,93
Maxwell Willman,28,NJD,C,18,3,1,4,1,2
Alexander Alexeyev,24,WSH,D,39,1,2,3,-8,6
Uvis Balinskis,27,FLA,D,26,1,2,3,0,8
Jordan Binnington,30,STL,G,57,0,3,3,0,8
Rourke Chartier,27,OTT,C,37,2,1,3,-4,14
Louis Crevier,22,CHI,D,24,0,3,3,-16,4
Angus Crookshank,24,OTT,LW,13,2,1,3,-3,4
Marc Del Gaizo,24,NSH,D,9,0,3,3,2,2
Trey Fix-Wolansky,24,CBJ,RW,11,2,1,3,0,2
Liam Foudy,23,2TM,C,13,0,3,3,-2,2
Liam Foudy,23,NSH,C,12,0,3,3,-2,2
Liam Foudy,23,CBJ,C,1,0,0,0,0,0
James Hamblin,24,EDM,F,31,2,1,3,3,0
Joel Hanley,32,2TM,D,42,1,4,5,3,30
Joel Hanley,32,DAL,D,32,0,3,3,3,23
Joel Hanley,32,CGY,D,10,1,1,2,0,7
Vinnie Hinostroza,29,PIT,C,14,1,2,3,-3,4
Connor Ingram,26,ARI,G,50,0,3,3,0,0
Erik Johnson,35,2TM,D,67,5,1,6,-14,26
Erik Johnson,35,BUF,D,50,3,0,3,-5,24
Erik Johnson,35,PHI,D,17,2,1,3,-9,2
Steven Lorentz,27,FLA,C,38,1,2,3,-9,10
Tristan Luneau,20,ANA,D,7,1,2,3,1,4
Zack MacEwen,27,OTT,C,30,2,1,3,-4,57
Brock McGinn,29,ANA,LW,24,1,2,3,-5,4
Jakob Pelletier,22,CGY,LW,13,1,2,3,1,2
Sheldon Rempal,28,VEG,RW,9,2,1,3,-2,4
Anthony Richard,27,BOS,C,9,1,2,3,0,2
Jonas Røndbjerg,24,VEG,RW,20,1,2,3,2,0
Mason Shaw,25,MIN,C,20,1,2,3,0,34
Ilya Solovyov,23,CGY,D,10,0,3,3,-3,4
Mitchell Stephens,26,MTL,C,23,2,1,3,2,4
Cam Talbot,36,LAK,G,54,0,3,3,0,4
Logan Thompson,26,VEG,G,46,0,3,3,0,0
Nikita Alexandrov,23,STL,C,23,0,2,2,-4,4
Ronald Attard,24,PHI,D,12,0,2,2,1,6
Adam Beckman,22,MIN,LW,11,0,2,2,-2,12
Matt Benning,29,SJS,D,14,0,2,2,-5,14
Brandon Biro,25,BUF,F,5,2,0,2,0,0
Sergei Bobrovsky,35,FLA,G,58,0,2,2,0,4
Philip Broberg,22,EDM,D,12,0,2,2,-3,0
Jake Christiansen,24,CBJ,D,12,0,2,2,-5,2
Maxwell Crozier,23,TBL,D,13,0,2,2,-2,7
Kirby Dach,23,MTL,C,2,0,2,2,2,0
Adam Edstrom,23,NYR,C,11,2,0,2,2,2
Simon Edvinsson,20,DET,D,16,1,1,2,0,4
Adam Erne,28,EDM,LW,24,1,1,2,0,9
Alexandar Georgiev,27,COL,G,63,0,2,2,0,4
Collin Graf,21,SJS,F,7,0,2,2,-4,0
Benoit-Olivier Groulx,23,ANA,C,45,0,2,2,-9,22
Denis Gurianov,26,2TM,RW,18,1,1,2,4,0
Denis Gurianov,26,NSH,RW,14,1,1,2,4,0
Denis Gurianov,26,PHI,RW,4,0,0,0,0,0
Daniil Gushchin,21,SJS,LW,4,1,1,2,-2,0
Santeri Hatakka,23,NJD,D,12,0,2,2,5,4
Matthew Highmore,27,OTT,LW,7,0,2,2,0,0
Lane Hutson,19,MTL,D,2,0,2,2,-2,0
Cole Koepke,25,TBL,LW,9,0,2,2,0,0
Milan Lucic,35,BOS,LW,4,0,2,2,-1,2
Kurtis MacDermid,29,2TM,D,45,2,1,3,4,73
Kurtis MacDermid,29,COL,D,29,2,0,2,3,23
Kurtis MacDermid,29,NJD,D,16,0,1,1,1,50
Jaycob Megna,31,CHI,D,44,0,2,2,-15,22
Carson Meyer,26,CBJ,RW,14,1,1,2,-2,2
Ben Meyers,25,2TM,F,23,1,2,3,-4,6
Ben Meyers,25,ANA,F,14,0,2,2,-2,6
Ben Meyers,25,COL,F,9,1,0,1,-2,0
Ian Mitchell,25,BOS,D,13,0,2,2,6,10
Sam Montembeault,27,MTL,G,41,0,2,2,0,0
Jordan Oesterle,31,CGY,D,22,0,2,2,-6,4
Liam Ohgren,20,MIN,LW,4,1,1,2,0,0
Nic Petan,28,MIN,C,6,0,2,2,-2,2
Vasily Podkolzin,22,VAN,RW,19,0,2,2,-4,8
Vasiliy Ponomarev,21,CAR,C,2,1,1,2,1,0
Cayden Primeau,24,MTL,G,23,0,2,2,0,2
Mikael Pyyhtia,22,CBJ,LW,17,0,2,2,-5,0
Matt Rempe,21,NYR,C,17,1,1,2,1,71
Lukáš Rousek,24,BUF,RW,15,0,2,2,-1,0
Juuse Saros,28,NSH,G,64,0,2,2,0,2
Akira Schmid,23,NJD,G,19,0,2,2,0,2
Jiri Smejkal,27,OTT,F,20,1,1,2,-6,4
Ilya Sorokin,28,NYI,G,56,0,2,2,0,0
Logan Stanley,25,WPG,D,25,1,1,2,4,36
Anthony Stolarz,30,FLA,G,27,0,2,2,0,2
Tyler Tucker,23,STL,D,26,1,1,2,1,42
Riley Tufte,25,COL,LW,5,1,1,2,-2,2
Andrei Vasilevskiy,29,TBL,G,52,0,2,2,0,2
Karel Vejmelka,27,ARI,G,38,0,2,2,0,2
Chris Wagner,32,COL,C,13,1,1,2,3,9
Jake Allen,33,2TM,G,34,0,1,1,0,2
Jake Allen,33,MTL,G,21,0,1,1,0,2
Jake Allen,33,NJD,G,13,0,0,0,0,0
Frederik Andersen,34,CAR,G,16,0,1,1,0,0
Nicklas Bäckström,36,WSH,C,8,0,1,1,-3,2
Nick Blankenburg,25,CBJ,D,12,1,0,1,1,4
Patrick Brown,31,BOS,C,11,0,1,1,-3,2
Nikita Chibrikov,20,WPG,RW,1,1,0,1,0,0
Kale Clague,25,BUF,D,3,0,1,1,0,2
Sam Colangelo,22,ANA,RW,3,1,0,1,0,2
Max Comtois,25,CAR,LW,1,0,1,1,0,0
Lukas Cormier,21,VEG,D,2,0,1,1,1,0
Logan Couture,34,SJS,C,6,0,1,1,0,4
Austin Czarnik,31,DET,C,34,0,1,1,-3,12
Nico Daws,23,NJD,G,21,0,1,1,0,0
Luca Del Bel Belluz,20,CBJ,C,1,1,0,1,1,0
Thatcher Demko,28,VAN,G,51,0,1,1,0,0
Casey DeSmith,32,VAN,G,29,0,1,1,0,0
Justin Dowling,33,NJD,C,2,1,0,1,-2,0
Samuel Fagemo,23,2TM,LW,8,1,0,1,-1,0
Samuel Fagemo,23,NSH,LW,4,1,0,1,0,0
Samuel Fagemo,23,LAK,LW,4,0,0,0,-1,0
Marc-André Fleury,39,MIN,G,40,0,1,1,0,4
Callan Foote,25,NJD,D,4,0,1,1,3,16
Nolan Foote,23,NJD,LW,4,1,0,1,-1,0
Anton Forsberg,31,OTT,G,30,0,1,1,0,2
Jean-Luc Foudy,21,COL,C,4,1,0,1,1,0
Mark Friedman,28,VAN,D,23,0,1,1,4,21
Byron Froese,32,VEG,C,16,0,1,1,-2,4
Cutter Gauthier,20,ANA,LW,1,0,1,1,1,0
Brandon Gignac,26,MTL,C,7,1,0,1,-3,0
Adam Ginning,24,PHI,D,9,1,0,1,0,0
Philipp Grubauer,32,SEA,G,36,0,1,1,0,4
Jonathan Gruden,23,PIT,C,13,1,0,1,-2,5
Filip Gustavsson,25,MIN,G,45,0,1,1,0,0
Hardy Haman Aktell,25,WSH,D,6,0,1,1,-2,2
Carter Hart,25,PHI,G,26,0,1,1,0,0
Adin Hill,27,VEG,G,35,0,1,1,0,0
Joel Hofer,23,STL,G,30,0,1,1,0,4
Daemon Hunt,21,MIN,D,12,0,1,1,-1,0
Ville Husso,28,DET,G,19,0,1,1,0,0
Ruslan Iskhakov,23,NYI,C,1,0,1,1,0,0
Tristan Jarry,28,PIT,G,51,1,0,1,0,4
Roby Jarventie,21,OTT,LW,7,0,1,1,-5,4
Jan Jeník,23,ARI,RW,5,0,1,1,-1,5
Lucas Johansen,26,WSH,D,6,0,1,1,1,4
Kaapo Kähkönen,27,2TM,G,37,0,1,1,0,4
Kaapo Kähkönen,27,SJS,G,31,0,1,1,0,4
Kaapo Kähkönen,27,NJD,G,6,0,0,0,0,0
Miloš Kelemen,24,ARI,F,10,0,1,1,-2,0
Adam Klapka,23,CGY,F,6,1,0,1,-1,19
Tyler Kleven,22,OTT,D,9,0,1,1,-1,2
Nikolai Knyzhov,25,SJS,D,10,0,1,1,-6,6
Joonas Korpisalo,29,OTT,G,55,0,1,1,0,0
Darcy Kuemper,33,WSH,G,33,0,1,1,0,0
Rasmus Kupari,23,WPG,C,28,0,1,1,-5,4
Maxime Lajoie,26,TOR,D,7,0,1,1,1,0
Brad Lambert,20,WPG,C,1,0,1,1,1,0
Kevin Lankinen,28,NSH,G,24,0,1,1,0,0
John Leonard,25,ARI,LW,6,1,0,1,-1,0
William Lockwood,25,FLA,RW,26,0,1,1,2,16
Ukko-Pekka Luukkonen,24,BUF,G,54,0,1,1,0,8
Alex Lyon,31,DET,G,44,0,1,1,0,2
Mackenzie MacEachern,29,STL,LW,8,0,1,1,-1,0
Logan Mailloux,20,MTL,D,1,0,1,1,1,0
Dylan McIlrath,31,WSH,D,3,0,1,1,1,5
Marc McLaughlin,24,BOS,F,1,1,0,1,1,0
Waltteri Merela,25,TBL,F,19,1,0,1,2,4
Jacob Moverare,25,LAK,D,24,1,0,1,0,6
Shakir Mukhamadullin,22,SJS,D,3,0,1,1,0,4
Frank Nazar,20,CHI,C,3,1,0,1,-4,0
Nikita Nesterenko,22,ANA,C,3,1,0,1,0,0
Jason Polin,24,COL,F,7,1,0,1,1,2
Jonathan Quick,38,NYR,G,27,0,1,1,0,8
Aku Raty,22,ARI,RW,1,0,1,1,0,0
Calle Rosén,29,STL,D,6,0,1,1,-1,2
Ilya Samsonov,26,TOR,G,40,0,1,1,0,0
Ryan Shea,26,PIT,D,31,1,0,1,1,6
Igor Shesterkin,28,NYR,G,55,0,1,1,0,6
Jack St. Ivany,24,PIT,D,14,0,1,1,0,2
Oskar Steen,25,BOS,C,34,1,0,1,-2,4
Jack Studnicka,24,2TM,C,22,1,0,1,-12,6
Jack Studnicka,24,VAN,C,5,1,0,1,2,0
Jack Studnicka,24,SJS,C,17,0,0,0,-14,6
Jeremy Swayman,25,BOS,G,44,0,1,1,0,0
Linus Ullmark,30,BOS,G,40,0,1,1,0,2
Vítek Vaněček,28,NJD,G,32,0,1,1,0,0
Egor Afanasyev,23,NSH,LW,2,0,0,0,-1,0
Emil Andrae,21,PHI,D,4,0,0,0,-1,0
Tyler Angle,23,CBJ,C,2,0,0,0,-1,0
Justus Annunen,23,COL,G,14,0,0,0,0,0
Kenneth Appleby,28,NYI,G,1,0,0,0,0,0
Yaroslav Askarov,21,NSH,G,2,0,0,0,0,0
Zach Aston-Reese,29,DET,C,3,0,0,0,0,2
Arshdeep Bains,23,VAN,F,8,0,0,0,-5,6
Tobias Björnfot,22,3TM,D,4,0,0,0,-2,2
Tobias Björnfot,22,FLA,D,1,0,0,0,0,0
Tobias Björnfot,22,LAK,D,1,0,0,0,0,0
Tobias Björnfot,22,VEG,D,2,0,0,0,-2,2
Mackenzie Blackwood,27,SJS,G,44,0,0,0,0,2
Jackson Blake,20,CAR,RW,1,0,0,0,-2,0
Anton Blidh,28,NYR,LW,1,0,0,0,-1,2
Robert Bortuzzo,34,2TM,D,27,0,0,0,0,27
Robert Bortuzzo,34,NYI,D,23,0,0,0,-2,20
Robert Bortuzzo,34,STL,D,4,0,0,0,2,7
Mavrik Bourque,22,DAL,C,1,0,0,0,0,0
Shane Bowers,24,NJD,C,8,0,0,0,1,0
Gavin Brindley,19,CBJ,C,1,0,0,0,0,0
Laurent Brossoit,30,WPG,G,23,0,0,0,0,2
Callahan Burke,26,CAR,C,1,0,0,0,0,0
Cameron Butler,21,CBJ,F,1,0,0,0,0,0
Jack Campbell,32,EDM,G,5,0,0,0,0,0
Declan Carlile,23,TBL,D,1,0,0,0,1,0
Magnus Chrona,23,SJS,G,9,0,0,0,0,0
Graeme Clarke,22,NJD,RW,3,0,0,0,-2,2
Dylan Coghlan,25,CAR,D,1,0,0,0,-2,0
Eric Comrie,28,BUF,G,10,0,0,0,0,0
Lucas Condotta,26,MTL,F,3,0,0,0,1,0
Devin Cooley,26,SJS,G,6,0,0,0,0,0
Pheonix Copley,32,LAK,G,8,0,0,0,0,0
Cameron Crotty,24,ARI,D,1,0,0,0,-1,0
Joey Daccord,27,SEA,G,50,0,0,0,0,0
Zach Dean,21,STL,C,9,0,0,0,-4,6
Ethan Del Mastro,21,CHI,D,2,0,0,0,0,0
Grigori Denisenko,23,VEG,LW,6,0,0,0,-3,2
Louis Domingue,31,NYR,G,1,0,0,0,0,0
Lukáš Dostál,23,ANA,G,44,0,0,0,0,8
Chris Driedger,29,SEA,G,2,0,0,0,0,0
Pierrick Dube,23,WSH,F,3,0,0,0,1,2
Samuel Ersson,24,PHI,G,51,0,0,0,0,4
Ivan Fedotov,27,PHI,G,3,0,0,0,0,0
Cale Fleury,25,SEA,D,1,0,0,0,1,0
Rhett Gardner,27,PHI,C,1,0,0,0,0,0
Adam Gaudette,27,STL,C,2,0,0,0,0,4
Glenn Gawdin,26,ANA,C,1,0,0,0,-1,2
John Gibson,30,ANA,G,46,0,0,0,0,12
Gage Goncalves,23,TBL,C,2,0,0,0,0,6
Jet Greaves,22,CBJ,G,9,0,0,0,0,0
Max Guenette,22,OTT,D,7,0,0,0,-1,2
Robert Hägg,28,ANA,D,5,0,0,0,-4,4
Brian Halonen,25,NJD,F,2,0,0,0,0,0
John Hayden,28,SEA,C,2,0,0,0,-1,0
Emil Heineman,22,MTL,LW,4,0,0,0,2,0
Magnus Hellberg,32,PIT,G,3,0,0,0,0,0
Connor Hellebuyck,30,WPG,G,60,0,0,0,0,2
Akito Hirose,24,VAN,D,3,0,0,0,1,0
Michael Hutchinson,33,DET,G,1,0,0,0,0,0
Grant Hutton,28,NYI,D,2,0,0,0,1,0
Bokondji Imama,27,OTT,LW,6,0,0,0,1,7
Vincent Iorio,21,WSH,D,6,0,0,0,1,0
Jonas Johansson,28,TBL,G,26,0,0,0,0,0
Marc Johnstone,27,PIT,F,1,0,0,0,-1,0
Martin Jones,34,TOR,G,22,0,0,0,0,0
Linus Karlsson,24,VAN,C,4,0,0,0,0,0
Philip Kemp,24,EDM,D,1,0,0,0,0,0
Jujhar Khaira,29,MIN,LW,1,0,0,0,0,0
Justin Kirkland,27,ARI,LW,2,0,0,0,0,0
Patrik Koch,27,ARI,D,1,0,0,0,0,10
Pyotr Kochetkov,24,CAR,G,42,0,0,0,0,8
Joona Koppanen,25,PIT,LW,4,0,0,0,0,0
Jiri Kulich,19,BUF,C,1,0,0,0,-1,0
Yan Kuznetsov,21,CGY,D,1,0,0,0,-1,0
Samuel Laberge,26,NJD,W,2,0,0,0,0,0
Raphael Lavoie,23,EDM,C,7,0,0,0,-2,2
Jake Leschyshyn,24,NYR,C,1,0,0,0,-1,0
Devon Levi,22,BUF,G,23,0,0,0,0,0
Kole Lind,25,SEA,RW,1,0,0,0,0,0
Oskar Lindblom,27,SJS,LW,1,0,0,0,-1,0
Charlie Lindgren,30,WSH,G,50,0,0,0,0,0
Connor Mackey,27,NYR,D,1,0,0,0,1,5
Spencer Martin,28,2TM,G,19,0,0,0,0,0
Spencer Martin,28,CAR,G,6,0,0,0,0,0
Spencer Martin,28,CBJ,G,13,0,0,0,0,0
Nikolas Matinpalo,25,OTT,D,4,0,0,0,1,0
Max McCormick,31,SEA,LW,1,0,0,0,0,0
Hugh McGing,25,STL,LW,5,0,0,0,-5,0
Cole McWard,22,VAN,D,1,0,0,0,0,0
Jayson Megna,33,BOS,C,1,0,0,0,0,0
Georgii Merkulov,23,BOS,F,4,0,0,0,1,0
Elvis Merzļikins,29,CBJ,G,41,0,0,0,0,4
Victor Mete,25,PHI,D,1,0,0,0,0,0
Fraser Minten,19,TOR,C,4,0,0,0,0,2
Logan Morrison,21,SEA,F,4,0,0,0,-1,0
Scott Morrow,21,CAR,D,2,0,0,0,-3,0
Petr Mrázek,31,CHI,G,56,0,0,0,0,14
Brett Murray,25,BUF,LW,2,0,0,0,-1,2
Matt Murray,25,DAL,G,1,0,0,0,0,0
Philippe Myers,27,TBL,D,5,0,0,0,-2,2
Bradly Nadeau,18,CAR,LW,1,0,0,0,-3,0
Riley Nash,34,NYR,C,1,0,0,0,0,0
Alex Nedeljkovic,28,PIT,G,38,0,0,0,0,0
Jake Oettinger,25,DAL,G,54,0,0,0,0,2
Oskar Olausson,21,COL,RW,1,0,0,0,0,0
Gustav Olofsson,29,SEA,D,1,0,0,0,0,0
Zack Ostapchuk,20,OTT,C,7,0,0,0,-1,0
Brennan Othmann,21,NYR,LW,3,0,0,0,0,0
Jiří Patera,24,VEG,G,6,0,0,0,0,0
Ondrej Pavel,23,COL,F,2,0,0,0,-1,2
Yaniv Perets,23,CAR,G,1,0,0,0,0,0
Calvin Petersen,29,PHI,G,5,0,0,0,0,0
Jacob Peterson,24,SJS,C,6,0,0,0,-3,2
Alexander Petrovic,31,DAL,D,1,0,0,0,-1,0
Calvin Pickard,31,EDM,G,23,0,0,0,0,2
Rem Pitlick,26,CHI,C,9,0,0,0,-7,2
Andrew Poturalski,30,SEA,C,2,0,0,0,-1,0
Samuel Poulin,22,PIT,RW,3,0,0,0,-1,2
Derrick Pouliot,30,DAL,D,5,0,0,0,-1,0
Ivan Prosvetov,24,COL,G,11,0,0,0,0,0
Antti Raanta,34,CAR,G,24,0,0,0,0,0
Adam Raška,22,MIN,RW,5,0,0,0,0,0
Pavol Regenda,24,ANA,F,5,0,0,0,-1,2
James Reimer,35,DET,G,25,0,0,0,0,4
Marshall Rifai,25,TOR,D,2,0,0,0,1,0
David Rittich,31,LAK,G,24,0,0,0,0,0
Georgi Romanov,24,SJS,G,2,0,0,0,0,0
Filip Roos,25,CHI,D,4,0,0,0,-4,0
Isak Rosen,20,BUF,RW,7,0,0,0,-3,0
Scott Sabourin,31,SJS,F,3,0,0,0,0,9
Mackie Samoskevich,21,FLA,RW,7,0,0,0,-3,0
Felix Sandström,27,PHI,G,5,0,0,0,0,0
Matthew Savoie,20,BUF,C,1,0,0,0,0,0
Brandon Scanlin,24,NYR,D,1,0,0,0,0,0
Cole Schwindt,22,CGY,RW,4,0,0,0,-1,2
Brett Seney,27,CHI,LW,4,0,0,0,0,6
Hunter Shepard,28,WSH,G,4,0,0,0,0,0
Arturs Silovs,22,VAN,G,4,0,0,0,0,0
Stuart Skinner,25,EDM,G,59,0,0,0,0,0
Joe Snively,28,WSH,F,3,0,0,0,-1,0
Arvid Söderblom,24,CHI,G,32,0,0,0,0,0
Victor Söderström,22,ARI,D,3,0,0,0,-1,0
Justin Sourdif,21,FLA,RW,3,0,0,0,0,0
Alex Steeves,24,TOR,F,1,0,0,0,-1,0
Marián Studenič,25,SEA,RW,2,0,0,0,-1,2
Malcolm Subban,30,CBJ,G,1,0,0,0,0,0
Maksymilian Szuber,21,ARI,D,1,0,0,0,-1,2
Mads Søgaard,23,OTT,G,6,0,0,0,0,0
Daniil Tarasov,24,CBJ,G,24,0,0,0,0,0
Jack Thompson,21,2TM,D,3,0,0,0,-2,0
Jack Thompson,21,SJS,D,2,0,0,0,-2,0
Jack Thompson,21,TBL,D,1,0,0,0,0,0
Matt Tomkins,29,TBL,G,6,0,0,0,0,0
Semyon Varlamov,35,NYI,G,28,0,0,0,0,0
Matt Villalta,24,ARI,G,2,0,0,0,0,0
Daniel Vladař,26,CGY,G,20,0,0,0,0,0
Samuel Walker,24,MIN,C,4,0,0,0,-3,0
Jesper Wallstedt,21,MIN,G,3,0,0,0,0,0
Scott Wedgewood,31,DAL,G,32,0,0,0,0,0
Colin White,27,2TM,C,28,0,0,0,-5,4
Colin White,27,MTL,C,17,0,0,0,-3,2
Colin White,27,PIT,C,11,0,0,0,-2,2
Ryan Winterton,20,SEA,C,9,0,0,0,-1,0
Dustin Wolf,22,CGY,G,17,0,0,0,0,0
Joseph Woll,25,TOR,G,25,0,0,0,0,0
